111111111111111111
10G100110010001001
100000E10110001001
100100110000101001
100100000011100001
100001011000001001
101101001011111011
100001101000100001
100101000010000101
110101111011011101
100100000000000P01
111111111111111111
